6
3
7
7
_#####_
##P--##
#--#--#
#-CMC-#
#--O--#
##-O-##
_#####_