5
2
7
7
__####_
###--#_
#P-OC##
#---C-#
#-#O--#
#-----#
#######
