7
3
6
8
######__
#----###
#---OO-#
#-CCCP-#
#--#-O-#
########