2
2
5
6
######
#P---#
#--CO#
#-OC-#
######
