4
2
6
7
######_
#P---##
#-CC--#
#-#O-O#
#-----#
#######
