10
3
6
8
_######_
##----##
#-OO---#
#-#-CCC#
#---#PO#
########