8
3
7
8
_#####__
##O--###
#--#-CP#
#--#-#-#
#-M--CO#
#----###
######__
