3
2
6
6
#####_
#P--##
#OCM-#
#--#-#
#----#
######
